a2z '=' A-Z packs
a7x '=' A7X Hero
A9  '=' Asphalt 9: Legends
ab '=' Aeon Bridge Discography
adagiodiscog '=' Adagio Discography
aep '=' The Eternal Project
ah1 '=' Angevil Hero
ah2 '=' Angevil Hero 2
ah3 '=' Angevil Hero 3
ah4 '=' Angevil Hero 4
ah5 '=' Angevil Hero 5
ahbe '=' Anti Hero: Beach Episode
alhambra '=' Alhambra Discography Setlist
altquest '=' Alt Quest
animehero '=' Anime Hero
antihero '=' Anti Hero
antihero2 '=' Anti Hero 2
attentionspan '=' Attention Span
bh '=' Band Hero
bhdlc '=' Band Hero DLC
bhds '=' Band Hero DS
bitcrusher '=' Bitcrusher
bitcrusherdlc '=' Bitcrusher DLC
blackhole '=' Black Hole
bnew '=' Brand New Hero
bodom '=' Bodom Hero
bs '=' Blanket Statement
catalyst '=' Catalyst
cb '=' Circuit Breaker
ccc '=' Customs Creator Collective
ch '=' Clone Hero
chan '=' Clone Hero Anime
charts '=' C.H.A.R.T.S.
charts2 '=' C.H.A.R.T.S. 2
chelhero '=' Chel Hero
clc '=' CamLikesCow Chart Pack
clonmania '=' Clonmania
cm100 '=' CLUB_MIX1
cm101 '=' CLUB_MIX1
cm102 '=' CLUB_MIX1
cm103 '=' CLUB_MIX1
cm104 '=' CLUB_MIX1
cm105 '=' CLUB_MIX1
cm106 '=' CLUB_MIX1
cm107 '=' CLUB_MIX1
cm108 '=' CLUB_MIX1
cm109 '=' CLUB_MIX1
cm110 '=' CLUB_MIX1
cm111 '=' CLUB_MIX1
cm112 '=' CLUB_MIX1
cm113 '=' CLUB_MIX1
cm114 '=' CLUB_MIX1
cm115 '=' CLUB_MIX1
cm116 '=' CLUB_MIX1
cm117 '=' CLUB_MIX1
cm118 '=' CLUB_MIX1
cm119 '=' CLUB_MIX1
cm120 '=' CLUB_MIX1
cm121 '=' CLUB_MIX1
cm20 '=' CLUB_MIX2
cm300 '=' CLUB_MIX3
gh1 '=' Guitar Hero
codered '=' Code Red
cowhero '=' Cow Hero
crystall '=' Crystallizer
csc '=' Custom Songs Central
csp '=' Community Snack Pack
CTC '=' Custom Thai-Songs Central
cth1 '=' Carpal Tunnel Hero
cth1r '=' Carpal Tunnel Hero: Remastered
cth2 '=' Carpal Tunnel Hero 2
cth3 '=' Carpal Tunnel Hero 3
cth3dlc '=' Carpal Tunnel Hero 3 DLC
dcr '=' Delta's Chart Repository
dfret '=' Don't Fret (With Matt Barron)
dfd '=' DragonForce Discography Setlist
DHC '=' Djent Hero Collection
dhc '=' Djent Hero Collection
digi '=' Digitizer
disgo '=' Disgorodraphy
ditr '=' Diamond in the Rough
djenthero '=' Djent Hero
djentherodlc '=' Djent Hero DLC
djh '=' DJ Hero
doomhero '=' Doom Hero Pack 1
drumblood '=' Drumblood
dynamix '=' Dynamix Pack
emotion '=' Emotional Rollercoaster
facelift '=' Facelift
FF '=' Final Fantasy: OST Hero
fh2 '=' Fatty Hero 2
fod '=' Fearofdark Discography
fof '=' Frets on Fire
fp '=' Focal Point
fp2 '=' Focal Point 2
fp2dh '=' Focal Point 2.DHumanity
fp3 '=' Focal Point 3
french '=' HexaNation
fruitsnacks '=' Razzy's Fruit Snacks
fuse '=' Fuse Box
GameChanger '=' Game Changer
gametal2 '=' GaMetal Power Pack #2
gd '=' GITADORA
gdch '=' Green Day Clone Hero Project
gdrb '=' Green Day: Rock Band
gdrbdlc '=' Green Day: Rock Band DLC
gf1 '=' GuitarFreaks
gf2dm1 '=' GuitarFreaks 2ndMIX & DrumMania
gh_hero '=' Guitar Hero Hero
gh2 '=' Guitar Hero II
gh2dlc '=' Guitar Hero II DLC
gh3 '=' Guitar Hero III: Legends of Rock
gh3dlc '=' Guitar Hero III: Legends of Rock DLC
gh5 '=' Guitar Hero 5
gh5dlc '=' Guitar Hero 5 DLC
gh80s '=' Guitar Hero Encore: Rocks the 80s
gha '=' Guitar Hero: Aerosmith
ghl '=' Guitar Hero Live
ghm '=' Guitar Hero: Metallica
ghmdlc '=' Guitar Hero: Metallica DLC
ghot '=' Guitar Hero: On Tour
ghotd '=' Guitar Hero On Tour: Decades
ghotmh '=' Guitar Hero On Tour: Modern Hits
ghsh '=' Guitar Hero: Smash Hits
ghtv '=' Guitar Hero TV
ghvh '=' Guitar Hero: Van Halen
ghwor '=' Guitar Hero: Warriors of Rock
ghwordlc '=' Guitar Hero: Warriors of Rock DLC
ghwt '=' Guitar Hero: World Tour
ghwtdlc '=' Guitar Hero: World Tour DLC
ghx2setlist '=' Guitar Hero X 2
ghxsetlist '=' Guitar Hero X
guitarknight '=' Guitar Knight
guitarzero2 '=' Guitar Zero 2
guitarzerodlc '=' Guitar Zero 2 DLC
gybe '=' Godspeed You! Black Emperor Discography
harmonyhero '=' Harmony Hero
hyenahero '=' Hyena Hero
idta '=' Initial D The Arcade
igniter '=' Igniter
imetal '=' Instru-Metal
indp '=' Indiependence Day
indoproject '=' I'M INDONESIA
isotope '=' Isotope
jarts '=' Jarts
jrb  '=' J-Rock Band
kh '=' Koreaboo Hero
kh2 '=' Koreaboo Hero 2
lanebreakers '=' Lane Breakers
lprb '=' Linkin Park Rock Band
lrb '=' LEGO Rock Band
lrbdlc '=' LEGO Rock Band DLC
lsimulator '=' Lawnmower Simulator
ma '=' Max Altitude
madlc '=' Max Altitude DLC
mania '=' Mania Hero
marathon '=' Marathon Hero
marathonhero2 '=' Marathon Hero 2
marfgh '=' marfGH
marfvol0 '=' marfGH: Volume 0
marfvol1 '=' marfGH: Volume 1
marfvol2 '=' marfGH: Volume 2
marfvol3 '=' marfGH: Volume 3
marfvol4 '=' marfGH: Volume 4
meshuggah '=' Meshuggah Discography
metallicadiscog '=' Guitar Hero Metallica: Complete Edition
miscellaneous '=' Miscellaneous Packs
miscgojira '=' Gojira Discography
miscmetallica '=' Metallica Discography
newbeat '=' New Beat
nirvanasp '=' Nirvana Discography
nowave '=' No Wave Song Pack
osta '=' OST Attack
osthero '=' OST Hero
pah '=' Plastarists Anonymous Hero
paradigm '=' Paradigm
pedahero '=' Peda Hero
pfn '=' P-Funk North
pg '=' Power Gig: Rise of the SixString
pgh2 '=' Project: Guitar Hero 2
ph '=' Parallax Hero
ph1 '=' Puppetz Hero I
ph2 '=' Puppetz Hero II
ph3 '=' Puppetz Hero III
ph4 '=' Puppetz Hero IV
phaseshift '=' Phase Shift
phc '=' Plastic Hero
phcg '=' Plastic Hero (Full Band)
phcs '=' Plastic Hero (Duos)
phdlc '=' Parallax Hero DLC
pile_of_hearts '=' The Void Rains Upon Her Heart
polkadot '=' POLKADOT STINGRAY Discography
pp '=' Phoenix Protocol
praise '=' Guitar Praise
psgp4 '=' Phase Shift Guitar Project 4
PSH '=' Plastic Shred Hero: Legends of Apathetic Charting
PSH2 '=' Plastic Shred hero 2
pstr '=' Project Strandberger
quag '=' QUAG
ra '=' Redemption Arc
ragequit '=' Rage Quit
ratpack '=' Rat Pack
rb1 '=' Rock Band 
rb1dlc '=' Rock Band DLC
rb2 '=' Rock Band 2
rb2dlc '=' Rock Band 2 DLC
rb3 '=' Rock Band 3
rb3dlc '=' Rock Band 3 DLC
rb4 '=' Rock Band 4
rb4dlc '=' Rock Band 4 DLC
rbacdc '=' AC/DC Live: Rock Band Track Pack
rbb '=' Rock Band Blitz
rbn '=' Rock Band Network
revolved '=' REVOLVED
rr '=' Rock Revolution
rsp '=' Russian Song Pack
Ryuman '=' Ryuman Pack
s_hero '=' S Hero
s_hero2 '=' S Hero 2
s64 '=' Shredz64
ScoreSpy '=' ScoreSpy
scu '=' Small Charters United
scufd '=' Small Charters United (Full Difficulty)
s2d4 = Songs to Die For
se '=' Symphonic Effect
shortcircuit '=' Short Circuit
shurikenhero '=' Shuriken Hero
soadrb '=' System of a Down Rock Band
soi '=' Shadow of Intent Discography
stems '=' S.T.E.M. PROJECT
stratodiscog '=' Stratovarius Discography
sxdisc '=' Symphony X Discography
synergy '=' Synergy
tbrb '=' The Beatles: Rock Band
tbrbcdlc '=' The Beatles: Rock Band Custom DLC Project
tbrbdlc '=' The Beatles: Rock Band DLC
tfoth '=' The Fall of Troy Hero
tfothplus '=' The Fall of Troy Hero +
thch '=' Tony Hawk's Clone Hero
thehero '=' The Hero
thps12 '=' Tony Hawk's Pro Skater 1+2 Soundtrack
transistor '=' Transistor
villainess '=' Villainess Pack
vortex_hero '=' Vortex Hero
weebs '=' Oops! All Weeb!
vtm '=' /v/
yis2 '=' YouTube Italia Sings 2
yorushika '=' Yorushika Discography
z '=' zDLCâ„¢
Zancharted '=' Zancharted
zancharted '=' Zancharted
zerogravity '=' Zero Gravity
zg3d '=' Zero Gravity: 3D
zgsb '=' Zero Gravity: Space Battle
